100
..ooo.....o.o..o.o..o...o..o...........o..o..............oo...o.o.................oo...ooo.....ooo..
oooo....o...oo...............ooo.o.ooo.o.........o......o.o.o............o.o..o.o.o.o.o.....o.....o.
......o.o....o..o.........oo..oo....ooooo...o...o.......o.........o....o.o.......o...o....o........o
....oo.....o..o.oo...o..........o.......o...o.......o......oo.........o....oo.o..o.o..o....o........
.oo.o.o..o.o.....o...o.oo..o..o.....o....o...oo.o.o......o....o.....o.oooo..o..........o......o..oo.
.o...o....o......o...................o..oo....o.oo.....o.....o.......o..oo...o......o.o.o....o...o..
o..o....o..ooo.o......oo.....o....oo....o..o...o.....o.......o....o.o.o......oo.o......oo.oo..o..oo.
..oo.oo........o..o...o......o.oo..o.....o..o....o..ooo.o.......oo...oo..o..o.o.o.o.o....o........oo
.....oooo..o....o..o............ooo..oo....o...o..o...o.oo....o....o.........o..o..oo.......o..o.o..
...oo.o....o..o.....o.....oo.o.o...o...oo.oo..o..o..o.o...o.o.oo..oo..............o...........o.....
......oo.oo.o....o....oo....oooo.o..oooo...o..oo......o..o.o......o......................o..........
o..oo..o...o....o.o..o...........o.o.o..o.oo.oo..o........o.o...oo..o.o.o.o....o....oo.oo....o...o..
....o.o.........oo.........o.....oooo...o.oo.o.o..oooo..o...o.....oo.oo...o......o.....o.......o.o..
..o......o...........o.o.oo.......o.....o.o..o....o....o..o.............o.o...o.................o.o.
..o......o....oo..oo..ooo............o.....oo.o.....o.....o............o.o.o..o.....ooo......o.o....
...o.o.....o..oo.oo.....o....o...o...o..o.o.....o..o.o.....o..oo.o......o....o..o..o..ooo.....o.oo..
.o....o..ooo...o..o..o...o..o...oo.....o...oo......o...o.........o...oo.......o...ooo..ooo.o.oo.....
o..oo........o........o......o..ooo.......o...oo.......o..oo....o......o.o....o....o.o........o.....
.....o.....o...o.o.o.o..oo...o...o.ooo...o...o.o.......o.oooo....o.ooooo.....o..o...o.o....oo..o....
.o.o...o.....o....o......oo..o....o..o.ooo.ooo...o..o....o.o..o...o.o..................o....o.o.oo..
o...o..oo....oo...................o......o...o....o......o..o...o.o....o..o..o..oo.o...........ooo..
...o..o.......oo....o.o......oo.o.........o....o...o.o.o..o..o.....o.ooo.oo.o.o...o.o..o.o...o...oo.
o.o.....o..o.....o...o....oo..o.oo.o.o.o.oo.....oo.o.....o....ooo....o....oo..o.........ooo.o...o.o.
...oo..o.......o.....o..o.....o.....o..oo.o..............o.oo.oo..o....o..o...o...o......o.o......o.
.o...............o.....o.o.......o..o.oo.....o...o......o....o..o.o...o..oo.o....o............o..o..
o......o.o..o.....o..o....o.........oooo.o...........o..o.......o....oooo...o.............o.........
...o....oo......o.o........o.o.o..ooo........o.....o.....o...o........o...o...o......o.o....oo.oo.o.
.oo.oo.o..o...oo.o....o.o..o.o....o...o.........o.o....o.o...oo.......o......o.o...o.....o..o..o.o..
...o.......o..o..oo....o.oo....o......o.........o..........o..oo.......o......o....o.o.o.....o.o....
........o.....oooo.o..o.ooo........o..................o.o......o..o.........o....o............oo.o.o
........o....o.......o....o.....o.ooo.o......o.o....o..o..o....o.o...o..o....o......o.o.ooo.......o.
.o.......ooo..o.........o..o......o..o.......o....o..o.....oo.....o.....o..o..o..........oo.oo.....o
......o...oo.oo..o...oo......oo...o..ooo...oo....o.o.o...oo....o...o.o..o.o........o..o.....oo...oo.
....oo.o.o.........oo.o........o...o..oo.o.oo......o.o..o.o.oo......o...o...oo..o.....oo..oo.o...oo.
o......o.....oooo.o..o.o..ooo...oo......o.o...oo.o....o..o.......oo..o.o..o.......oooo.o.......o..oo
...o..o..o...o....o.......o....oo...o......o.....o.......oo......o.o.o..........o..o.....o...o..o.o.
......oo.o.o.........ooo.oo.....o.................o...o..o..oo.o......o....oo.....o..o...o..........
...........o....o.oo............oo........o.oo...o...o....o.oo.oo.o..oooo...oo.o...o...oo.o..o...o..
....oo.o.o.......o..o.....o...oo.o....ooo....oo.oo.oo....o.oo..o.o..o..o....o..o...o.......oo...o...
.oo....oo....o.oo.o.......o....o...o..o.....o...o.oo..o...o.....o.oo.........o..o....o.....oo..o....
....o.o.o...oo...o.o......o.o.o.oo..o.o.o.o...o..................oo.o......ooo....o.ooo.....o....o..
.o..........o.....o........o...o....o..o..o..o.o..oooo.o..o.....o......ooo..o.o..o.........oo....o.o
.........o.oo.o.o.o.o............oo...o...ooo..oo.......oo.o...oo.o.....o........ooo....o....o.o..oo
..........o....o....o..o.........o..........o.o....oo..o......o..o....o.ooo.o..o.o..o....oo.o.oo.o..
.......o...o..........o.....ooo...o..o...oo...oo..oo......................o.ooo..oo.o..oo.o...o.o...
.o...o............o.oo....o.oo..........o..ooo.o..o..........o.o......oo..o...o.....oo.oo.o..o....o.
...o..oo...o..........o.o.....o..o....o.o.oo......o...o.o........o.......o.........o......o...o.....
o......................o..........o...........o.o...o........o.............o..o.......o.oo.o..o.....
..o...o.oo.....o....o.....o.....oo....oo...oo....oo..o.....o.o..o..........o.o..............o...o...
o......o...oo..o..o...o.oo..o...o....o...o..oo............o............o......o.....o.....oo....oo.o
...o......o.........o...o.o.....o......oo...o..o......o....o..oo.........o.ooo..o..oo.o..o.o....o..o
..ooo.......o.......o....o.o.o..o....o...o....o..o....oo.........ooo..o............o.........o..o...
...oo...o....o.....o....o..o....o.oo...oo.ooo..o.......o..........o..o.......o..o......o..o.o.o.oo..
oo.o.......o.o..oo.o.....o.o.o..o....o.o.oo.....o..............o.......o....o...o.o..o......o......o
.....o.....ooo....o.o.oo.......oo.......o.o...oo.........o.o.......oooo.o..o.o......o.....o..o.o....
...o.............o.......o.ooo...........ooo...oo.................o.o.o........o.......o.....o....o.
....oo.o......oo.o.oo...o...o....o.o.......oo..o.........oo.oooo..ooo.o...ooo.oo.o..oo..ooo.....oo..
.o.o....o................o..o.ooo......oo............o..........oo..o..o....o......o.o...oo...o..o..
....o...o.....oo.....o.o.oo......o..o.........o..oo.....o...oo.....o.....o..oo.....o.oo..oo.o.oo....
.oo.......o..o.....o.o..o.......o.o.oo...o........o..o.o........o......oo....o.oo.....o....oooo.o.o.
.ooo.o........o..o.......o.oo..o....o....o.o..oo....o..........o..o.......o......o.............o...o
...o...o.o.o....o..o.o....o....o.o....o...o.....o.....oo..o....o...o..o...o.o..o.o..o........o......
..oo...o..o......o.......o.....ooooo.o..oo.oo.o.o.o..o..oo........ooo.oo.o...o....oo..oo..........oo
.....o...o.ooo......oo.oo..o...o........o.o.....o...o.o...o.ooo.......o.......o.o...........o.o.....
..o.......oo.....oo.o.o........o.oo.o...o.o....o..o..oo.o...o.oo........o.........o.o..o..........oo
...o........o....oo......o...o.oooo..oo.o........o...ooo.......oo............o.o.......o....o.oo....
o.o.o........ooo....o......ooo...o.oo..o.o.........o.....o.o..o.o......o..oo..........oo....o.o...o.
..o......o....o...o.oo.oo...o...o.oo.....o.o....oo.o.....o.o....o......o..o...o..o.oo..o.....o......
..o......o..o..o.o..o.......o.....o......o..........o...o..oo...o.o.oo....ooo...o.o..o.oo...o..o....
.o....o........o...o......o.......oo.............o..o......o......o..ooo.o..............oo.o..o.....
....o.......o..o.o...ooo......o.o...o.o.o...........o.o.ooo....o.......oo.o..o.o....o...o......o....
..o........ooo.....o.....oo.oo........o....o..o....o....o...o.....o..o.oo........o...ooo..o..oo..o..
...o.o..o.......oo...o....o...oo..oo....oo...o..oo..o.o.....o....oo.........oo.....o.........o...o..
...o...o....oo.........oo.o...o......o.............o.o........oo.o.o.....o...o..oo......o.o.oo......
....oo.....o.o...............oo.o..o...................ooo...................o..o.........o..oo.....
.o.o.....o.......o...o...oo.o..o...o..o.o..o....ooo.oo.o..o...o.....oo.o.o.oo.ooo...............oo..
.......o..o..o....o..o..o......o....o.o.........o..oo.....o.....o.........oo......o..o....o...oo.o..
......o.o......o...oo......o...o.o...oo..o........o.o......oo...o.ooo......o....o......o...o....o...
o.o...o.o.....o............ooo............oo.oooo.....o.o....oo...o.....o......................o..o.
o......ooo........o.....o...o.......o..o...........o..........o.....o...o.oo..ooo..................o
....o.oo.....oo.................o..o..o..o....o.o.....o..o..o.......o.oo...o.......o.o......ooo....o
.o.o.oo.ooo.....o.o..o..o.o.oo.o....o..................o......o......o..o......o....o.o.o.......o...
o........ooo....o..oo..........o.o....oo....oo.o..o.o...o.......oo..o.oo.o.o....o.....oo....o....oo.
....oo.......o....o....ooo.....o.......o.oo....o...o.......................oo..o.........o..........
..oo.................o.....oo...o.......o..o.o.......o..o.....o......o...o....o.o.oooo.......o...o.o
o.o..o....o.oo.o.o..o..o...oo......o...o.........o....o.oo.o........o.........o....oo.......o.ooo..o
o.....o.o.o.o..o..o......o.........oo.o.......oo...o.o.ooo....o..o.....ooo.....o.oooo...oo...oo...o.
o....o...o.o........o.o.o........o.oo..o.........o........oo...ooo.o..o...o.o.........o.............
..o..oo..ooo......o....oo....oo.ooooo.....o......o..o............o....oo.o.....o...ooo.......o...o..
..o...o....o....o........o.......o...........ooo...o......oo..o.........oo.o..o.......oo..o.oo..o...
................o.......o.oo..oo.o....o....o.oo....o......o..oo....oo............o.......o.........o
oo....o.o.o.....ooo..o....ooo.o.o...oo..o...o.........oo......o..o..o.ooo....o.oo..............o....
..o........o....o..oo.......ooo.o.oo..........o.o...o..o..o......ooo.........oo.........oo...o.o.o..
..ooo...o...oo.o...oo...o.o..o..oo.o...........oo..o..oo.o.o...oo..o.oo.....o.oo.o.............oo...
o......o.o....o...o.ooo........o.....o...o..o....o..o....o.o......o........o..o....o..o......o..o...
...oo...ooo..o.ooo.......o.o...ooo.......o.........oo.....oo.o..oo..oooo.oo....o........o.....o.....
.o....oo....oooo.....o....o...o...ooooo.....o.o....oo..o..oooo..o.....o..o......o.oo.....o....o...o.
o......o......oo......o......o......oo....o.....o...oo......o..ooo..oo...o....o....o........o..o..oo
..o...o.....o...o....oooo.o.o..o.o.o.......o.o.o......o...................o.o.o......oo........oo...
..o.................o...............o....o.oooo....o...o......oo....o.......o......ooo......o.......
